tileswide 25
tileshigh 25
tilewidth 32
tileheight 32

layer 0
0,21,20,0,0,0,0,0,0,0,0,0,0,0,0,0,0,0,0,0,0,21,24,20,0,
21,25,23,20,21,20,0,0,0,21,24,24,24,24,20,0,0,0,0,0,21,25,2,16,0,
22,3,4,23,25,23,24,20,21,25,2,2,2,2,23,20,0,0,0,0,22,2,2,16,0,
22,8,2,2,2,2,2,23,25,2,2,2,2,2,2,23,20,0,0,0,22,2,2,16,0,
19,15,7,2,2,2,2,2,2,2,2,2,2,2,2,2,23,24,24,24,25,2,2,16,0,
0,22,8,26,6,2,2,2,2,2,2,2,2,2,2,2,2,2,2,2,2,2,2,16,0,
0,19,14,15,8,26,6,2,2,2,2,2,2,2,2,2,2,2,2,2,2,13,14,18,0,
0,0,0,19,14,15,7,2,2,2,2,2,2,2,2,2,2,2,2,2,13,0,0,0,0,
0,0,0,0,0,22,7,2,2,2,2,2,2,2,2,2,13,14,14,14,18,0,0,0,0,
0,0,0,0,0,22,7,2,2,2,2,2,2,2,2,2,16,0,0,0,0,0,0,0,0,
0,0,0,0,21,25,7,2,2,2,2,2,2,2,2,2,23,24,20,0,0,0,0,0,0,
0,0,0,21,25,3,12,26,26,26,2,2,2,26,26,26,11,4,16,0,0,0,0,0,0,
0,0,21,25,3,12,9,13,14,15,8,26,9,13,14,15,8,9,23,24,24,24,20,0,0,
0,21,25,3,12,9,13,18,0,19,15,2,13,0,0,19,14,15,3,11,11,4,16,0,0,
0,19,15,8,9,13,18,0,0,0,19,14,18,0,0,0,0,22,7,2,17,9,16,0,0,
0,0,19,14,14,18,0,0,0,0,0,0,0,0,0,0,0,22,7,2,5,13,18,0,0,
0,0,0,0,0,0,0,0,0,0,0,0,0,0,0,0,21,25,7,2,5,23,20,0,0,
0,0,0,0,0,0,0,0,0,0,0,0,0,0,0,21,25,3,12,2,10,4,23,0,0,
0,0,0,0,0,0,21,24,20,0,0,0,0,0,0,0,15,8,6,2,2,5,13,18,0,
0,0,0,0,21,24,25,11,23,20,0,0,0,0,0,0,19,15,8,6,2,5,23,20,0,
0,0,0,21,25,2,6,2,2,16,21,24,24,20,0,0,0,19,15,7,17,9,13,18,0,
0,0,0,19,15,2,2,2,2,23,25,4,13,18,0,0,0,21,25,8,9,13,18,0,0,
0,0,0,0,19,15,26,26,2,2,2,5,16,0,0,0,0,19,14,14,14,18,0,0,0,
0,0,0,0,0,19,14,14,14,14,15,9,23,20,0,0,0,0,0,0,0,0,0,0,0,
0,0,0,0,0,0,0,0,0,0,19,14,14,18,0,0,0,0,0,0,0,0,0,0,0,

