00,21,20,00,00,00,00,00,00,00,00,00,00,00,00,00,00,00,00,00,00,21,24,20,00
21,25,23,20,21,20,00,00,00,21,24,24,24,24,20,00,00,00,00,00,21,25,02,16,00
22,03,04,23,25,23,24,20,21,25,02,02,02,02,23,20,00,00,00,00,22,02,02,16,00
22,08,02,02,02,02,02,23,25,02,02,02,02,02,02,23,20,00,00,00,22,02,02,16,00
19,15,07,02,02,02,02,02,02,02,02,02,02,02,02,02,23,24,24,24,25,02,02,16,00
00,22,08,26,06,02,02,02,02,02,02,02,02,02,02,02,02,02,02,02,02,02,02,16,00
00,19,14,15,08,26,06,02,02,02,02,02,02,02,02,02,02,02,02,02,02,13,14,18,00
00,00,00,19,14,15,07,02,02,02,02,02,02,02,02,02,02,02,02,02,13,00,00,00,00
00,00,00,00,00,22,07,02,02,02,02,02,02,02,02,02,13,14,14,14,18,00,00,00,00
00,00,00,00,00,22,07,02,02,02,02,02,02,02,02,02,16,00,00,00,00,00,00,00,00
00,00,00,00,21,25,07,02,02,02,02,02,02,02,02,02,23,24,20,00,00,00,00,00,00
00,00,00,21,25,03,12,26,26,26,02,02,02,26,26,26,11,04,16,00,00,00,00,00,00
00,00,21,25,03,12,09,13,14,15,08,26,09,13,14,15,08,09,23,24,24,24,20,00,00
00,21,25,03,12,09,13,18,00,19,15,02,13,00,00,19,14,15,03,11,11,04,16,00,00
00,19,15,08,09,13,18,00,00,00,19,14,18,00,00,00,00,22,07,02,17,09,16,00,00
00,00,19,14,14,18,00,00,00,00,00,00,00,00,00,00,00,22,07,02,05,13,18,00,00
00,00,00,00,00,00,00,00,00,00,00,00,00,00,00,00,21,25,07,02,05,23,20,00,00
00,00,00,00,00,00,00,00,00,00,00,00,00,00,00,21,25,03,12,02,10,04,23,00,00
00,00,00,00,00,00,21,24,20,00,00,00,00,00,00,00,15,08,06,02,02,05,13,18,00
00,00,00,00,21,24,25,11,23,20,00,00,00,00,00,00,19,15,08,06,02,05,23,20,00
00,00,00,21,25,02,06,02,02,16,21,24,24,20,00,00,00,19,15,07,17,09,13,18,00
00,00,00,19,15,02,02,02,02,23,25,04,13,18,00,00,00,21,25,08,09,13,18,00,00
00,00,00,00,19,15,26,26,02,02,02,05,16,00,00,00,00,19,14,14,14,18,00,00,00
00,00,00,00,00,19,14,14,14,14,15,09,23,20,00,00,00,00,00,00,00,00,00,00,00
00,00,00,00,00,00,00,00,00,00,19,14,14,18,00,00,00,00,00,00,00,00,00,00,00

